18 18 18 18 18 18 18 18 18 18 18 18 18 18 18 18 18 18 18 18 18 18 18 18 18 18 18 18 18 18 18 18 18 18 18 18 18 18 18 18 18 18 18 18 18 18 18 18 18 18 
18 18 18 18 18 18 18 18 18 18 18 18 18 18 18 18 18 18 18 18 18 18 18 18 18 18 18 18 18 18 18 18 18 18 18 18 18 18 18 18 18 18 18 18 18 18 18 18 18 18 
18 18 18 18 18 18 18 18 18 18 18 18 18 18 18 18 18 18 18 18 18 18 18 18 18 18 18 18 18 18 18 18 18 18 18 18 18 18 18 18 18 18 18 18 18 18 18 18 18 18 
18 18 18 18 18 18 18 18 18 18 18 18 18 18 18 18 18 18 18 18 18 18 18 18 18 18 18 18 18 18 18 18 18 18 18 18 18 18 18 18 18 18 18 18 18 18 18 18 18 18 
18 18 18 18 18 18 18 18 18 18 18 18 18 18 18 18 18 18 18 18 18 18 18 18 18 18 18 18 18 18 18 18 18 18 18 18 18 18 18 18 18 18 18 18 18 18 18 18 18 18 
18 18 18 18 18 18 18 18 18 18 18 18 18 18 18 18 18 18 18 18 18 18 18 18 18 18 18 18 18 18 18 18 18 18 18 18 18 18 18 18 18 18 18 18 18 18 18 18 18 18 
18 18 18 18 18 18 18 18 18 18 18 18 18 18 18 18 18 28 26 26 26 26 26 26 26 26 26 26 26 26 26 29 18 18 18 18 18 18 18 18 18 18 18 18 18 18 18 18 18 18 
18 18 18 18 18 18 18 18 18 18 18 18 18 18 18 18 18 24 1 1 1 1 2 1 1 1 1 1 1 1 1 25 26 26 26 29 18 18 18 18 18 18 18 18 18 18 18 18 18 18 
18 18 18 18 18 18 18 18 18 18 18 18 18 18 28 26 26 27 1 1 1 1 1 1 1 1 1 1 1 1 1 1 1 1 1 25 29 18 18 18 18 18 18 18 18 18 18 18 18 18 
18 18 18 18 18 18 18 18 18 18 18 18 28 26 27 16 16 16 1 1 1 20 21 21 21 21 22 1 1 2 1 1 1 1 1 1 25 26 26 26 26 29 18 18 18 18 18 18 18 18 
18 18 18 18 18 18 18 18 18 28 26 26 27 1 1 1 1 1 1 2 1 23 18 18 18 18 30 21 22 16 1 1 1 1 1 1 2 1 1 1 1 25 26 26 29 18 18 18 18 18 
18 18 18 18 18 18 28 26 26 27 1 2 1 1 1 1 1 1 1 1 1 25 26 29 18 18 18 18 30 22 1 16 1 1 1 1 1 1 1 1 1 1 1 1 23 18 18 18 18 18 
18 18 18 18 18 18 24 16 1 1 1 1 1 1 1 20 21 21 21 22 1 1 1 25 26 26 26 29 18 30 21 21 22 16 1 1 1 1 1 1 1 2 1 1 25 29 18 18 18 18 
18 18 18 18 18 18 24 1 1 1 1 2 1 20 21 31 18 18 18 30 21 22 1 1 1 1 1 23 18 18 18 18 30 21 21 21 21 21 22 1 1 1 1 1 1 25 29 18 18 18 
18 18 18 18 18 18 24 1 1 1 20 21 21 31 18 18 18 18 18 18 18 30 21 21 22 1 20 31 18 18 18 18 18 18 18 18 18 18 30 22 1 1 1 1 1 1 25 29 18 18 
18 18 18 18 18 18 24 1 1 20 31 18 18 18 18 18 18 18 18 18 18 18 28 26 27 1 25 26 26 26 29 18 18 18 18 18 18 18 18 30 22 1 1 1 1 1 1 23 18 18 
18 18 18 18 18 18 24 1 1 23 18 18 18 18 18 18 28 26 26 26 26 26 27 1 1 1 1 1 1 1 25 29 18 18 18 18 18 18 18 18 30 22 1 1 1 1 1 23 18 18 
18 18 18 18 18 18 24 1 1 23 18 18 18 18 18 18 24 16 16 16 1 1 1 1 1 1 1 1 1 16 1 25 29 18 18 18 18 18 18 18 18 24 2 1 1 1 16 23 18 18 
18 18 18 18 18 18 24 1 1 23 18 18 18 18 18 18 24 16 16 16 1 2 1 1 1 1 1 2 1 1 1 1 23 18 18 28 26 26 26 26 29 30 22 1 1 1 1 23 18 18 
18 18 18 18 18 18 24 1 1 23 18 18 18 18 18 18 24 16 16 16 16 1 1 12 10 13 1 1 1 1 2 1 25 26 26 27 1 1 1 1 25 26 27 1 1 1 1 23 18 18 
18 18 18 18 18 28 27 2 1 23 18 18 18 18 18 18 30 21 22 16 1 1 1 8 3 9 33 10 13 1 1 1 1 1 1 1 2 1 1 1 1 1 1 1 2 1 1 23 18 18 
18 18 18 18 18 24 1 1 1 23 18 18 28 26 29 18 28 26 27 1 1 1 1 8 3 3 3 3 7 1 16 1 20 22 1 1 1 20 21 22 1 1 1 1 1 1 20 31 18 18 
18 18 18 18 18 24 1 1 1 25 26 26 27 1 25 26 27 1 1 1 1 2 1 14 5 5 5 5 15 1 1 1 23 30 21 21 21 31 18 30 21 21 22 1 1 1 23 18 18 18 
18 18 18 18 18 30 22 1 1 1 1 1 1 2 1 1 1 1 20 22 1 2 1 1 1 1 1 1 1 2 1 1 23 18 18 18 18 18 18 18 28 26 27 1 1 16 23 18 18 18 
18 18 18 18 18 18 24 1 1 1 1 1 1 1 1 1 1 20 31 24 16 16 16 1 20 21 21 22 1 20 21 21 31 18 18 18 18 18 18 18 24 16 1 1 1 1 23 18 18 18 
18 18 18 18 18 18 24 1 2 1 1 1 1 1 1 1 20 31 18 30 21 21 21 21 31 18 18 30 21 31 18 18 18 18 18 18 18 18 18 28 27 1 1 1 1 1 23 18 18 18 
18 18 18 18 18 18 30 22 1 1 1 1 20 21 21 21 31 18 18 18 18 28 26 26 26 26 26 26 29 18 18 18 18 18 18 18 18 18 28 27 1 1 1 1 2 1 23 18 18 18 
18 18 18 18 18 18 18 24 1 1 1 1 25 26 29 18 18 18 18 18 28 27 2 12 10 10 13 2 25 29 18 18 18 18 18 18 28 26 27 1 1 1 1 1 20 21 31 18 18 18 
18 18 18 18 18 18 18 30 22 1 1 1 1 1 25 29 18 18 18 18 24 1 1 8 3 3 7 1 1 23 18 18 18 18 18 28 27 1 1 1 1 1 1 20 31 18 18 18 18 18 
18 18 18 18 18 18 18 18 30 22 1 1 1 1 1 25 29 18 18 18 24 1 1 8 3 3 7 1 1 23 18 18 18 18 28 27 1 2 1 1 1 1 1 23 18 18 18 18 18 18 
18 18 18 18 18 18 18 18 18 30 22 1 2 1 1 1 25 29 18 18 30 22 1 14 5 5 15 1 20 31 18 18 18 18 24 1 1 1 1 1 1 1 20 31 18 18 18 18 18 18 
18 18 18 18 18 18 18 18 18 18 24 1 1 1 1 1 1 25 29 18 18 30 21 22 1 1 20 21 31 18 18 18 28 26 27 1 1 1 1 1 1 20 31 18 18 18 18 18 18 18 
18 18 18 18 18 18 18 18 18 18 30 22 1 1 1 1 1 1 25 26 26 26 29 24 1 1 23 28 26 26 26 26 27 1 1 1 2 1 1 20 21 31 18 18 18 18 18 18 18 18 
18 18 18 18 18 18 18 18 18 18 18 24 1 1 1 1 1 1 1 1 1 1 25 27 1 1 25 27 1 1 1 1 1 1 1 1 16 16 20 31 18 18 18 18 18 18 18 18 18 18 
18 18 18 18 18 18 18 18 18 18 18 30 22 1 2 2 1 1 1 1 2 1 1 1 1 1 1 1 1 1 1 1 1 1 16 16 16 20 31 18 18 18 18 18 18 18 18 18 18 18 
18 18 18 18 18 18 18 18 18 18 18 18 30 22 1 1 1 1 1 1 1 1 1 1 2 1 1 1 1 1 1 16 16 16 16 16 20 31 18 18 18 18 18 18 18 18 18 18 18 18 
18 18 18 18 18 18 18 18 18 18 18 18 18 30 21 21 21 21 21 21 21 21 22 1 1 1 1 2 1 1 20 21 21 21 21 21 31 18 18 18 18 18 18 18 18 18 18 18 18 18 
18 18 18 18 18 18 18 18 18 18 18 18 18 18 18 18 18 18 18 18 18 18 30 21 21 21 21 21 21 21 31 18 18 18 18 18 18 18 18 18 18 18 18 18 18 18 18 18 18 18 
18 18 18 18 18 18 18 18 18 18 18 18 18 18 18 18 18 18 18 18 18 18 18 18 18 18 18 18 18 18 18 18 18 18 18 18 18 18 18 18 18 18 18 18 18 18 18 18 18 18 
18 18 18 18 18 18 18 18 18 18 18 18 18 18 18 18 18 18 18 18 18 18 18 18 18 18 18 18 18 18 18 18 18 18 18 18 18 18 18 18 18 18 18 18 18 18 18 18 18 18 
18 18 18 18 18 18 18 18 18 18 18 18 18 18 18 18 18 18 18 18 18 18 18 18 18 18 18 18 18 18 18 18 18 18 18 18 18 18 18 18 18 18 18 18 18 18 18 18 18 18 
18 18 18 18 18 18 18 18 18 18 18 18 18 18 18 18 18 18 18 18 18 18 18 18 18 18 18 18 18 18 18 18 18 18 18 18 18 18 18 18 18 18 18 18 18 18 18 18 18 18 
18 18 18 18 18 18 18 18 18 18 18 18 18 18 18 18 18 18 18 18 18 18 18 18 18 18 18 18 18 18 18 18 18 18 18 18 18 18 18 18 18 18 18 18 18 18 18 18 18 18 
18 18 18 18 18 18 18 18 18 18 18 18 18 18 18 18 18 18 18 18 18 18 18 18 18 18 18 18 18 18 18 18 18 18 18 18 18 18 18 18 18 18 18 18 18 18 18 18 18 18 
18 18 18 18 18 18 18 18 18 18 18 18 18 18 18 18 18 18 18 18 18 18 18 18 18 18 18 18 18 18 18 18 18 18 18 18 18 18 18 18 18 18 18 18 18 18 18 18 18 18 
18 18 18 18 18 18 18 18 18 18 18 18 18 18 18 18 18 18 18 18 18 18 18 18 18 18 18 18 18 18 18 18 18 18 18 18 18 18 18 18 18 18 18 18 18 18 18 18 18 18 
18 18 18 18 18 18 18 18 18 18 18 18 18 18 18 18 18 18 18 18 18 18 18 18 18 18 18 18 18 18 18 18 18 18 18 18 18 18 18 18 18 18 18 18 18 18 18 18 18 18 
18 18 18 18 18 18 18 18 18 18 18 18 18 18 18 18 18 18 18 18 18 18 18 18 18 18 18 18 18 18 18 18 18 18 18 18 18 18 18 18 18 18 18 18 18 18 18 18 18 18 
18 18 18 18 18 18 18 18 18 18 18 18 18 18 18 18 18 18 18 18 18 18 18 18 18 18 18 18 18 18 18 18 18 18 18 18 18 18 18 18 18 18 18 18 18 18 18 18 18 18 
18 18 18 18 18 18 18 18 18 18 18 18 18 18 18 18 18 18 18 18 18 18 18 18 18 18 18 18 18 18 18 18 18 18 18 18 18 18 18 18 18 18 18 18 18 18 18 18 18 18 
