36 36 36 36 36 36 36 36 36 36 36 36 36 36 36 36 36 36 36 36 36 36 36 36 36 36 36 36 36 36 36 36 36 36 36 36 36 36 36 36 36 36 36 36 36 36 36 36 36 36 
36 36 36 36 36 36 36 36 36 36 36 36 36 36 36 36 36 36 36 36 36 36 36 36 36 36 36 36 36 36 36 36 36 36 36 36 36 36 36 36 36 36 36 36 36 36 36 36 36 36 
36 36 36 36 36 36 36 36 36 36 36 36 36 36 36 36 36 36 36 36 36 36 36 36 36 36 36 36 36 36 36 36 36 36 36 36 36 36 36 36 36 36 36 36 36 36 36 36 36 36 
36 36 36 36 36 36 36 36 36 36 36 36 36 36 36 36 36 36 36 36 36 36 36 36 36 36 36 36 36 36 36 36 36 36 36 36 36 36 36 36 36 36 36 36 36 36 36 36 36 36 
36 36 36 36 36 36 36 36 36 36 36 36 36 36 36 36 36 36 36 36 36 36 36 36 36 36 36 36 36 36 36 36 36 36 36 36 36 36 36 36 36 36 36 36 36 36 36 36 36 36 
36 36 36 36 36 36 36 36 36 36 36 36 36 36 36 36 36 36 36 36 36 36 36 36 36 36 36 36 36 36 36 36 36 36 36 36 36 36 36 36 36 36 36 36 36 36 36 36 36 36 
36 36 36 36 36 36 36 36 36 36 36 36 36 36 36 36 36 36 36 36 36 36 36 36 36 36 36 36 36 36 36 36 36 36 36 36 36 36 36 36 36 36 36 36 36 36 36 36 36 36 
36 36 36 36 36 36 36 36 36 36 36 36 36 36 36 36 36 36 36 36 36 36 36 36 36 36 36 36 36 36 36 36 36 36 36 36 36 36 36 36 36 36 36 36 36 36 36 36 36 36 
36 36 36 36 36 36 36 36 36 36 36 36 36 36 36 36 36 36 36 36 36 36 36 36 36 36 36 36 36 36 36 36 36 36 36 36 36 36 36 36 36 36 36 36 36 36 36 36 36 36 
36 36 36 36 36 36 36 36 36 36 36 36 36 36 36 36 36 36 36 36 36 36 36 36 36 36 36 36 36 36 36 36 36 36 36 36 36 36 36 36 36 36 36 36 36 36 36 36 36 36 
36 36 36 36 36 36 36 36 36 36 36 36 36 36 36 70 56 56 56 56 56 56 56 56 56 56 56 56 56 56 56 56 56 56 56 56 56 56 56 56 56 56 56 56 56 56 56 56 56 71 
36 36 36 36 36 36 36 36 36 36 36 36 36 36 36 37 33 33 33 33 33 33 33 33 33 33 33 33 33 33 33 33 33 33 33 33 33 33 33 33 33 33 33 33 33 33 33 33 33 35 
36 36 36 36 36 36 36 36 36 36 36 36 36 36 36 37 33 12 13 13 13 13 13 13 13 13 13 13 13 13 13 13 13 13 13 13 13 13 13 13 13 13 13 13 13 13 13 14 33 35 
36 36 36 36 36 36 36 36 36 36 36 36 36 36 36 37 33 32 33 33 33 33 33 33 33 33 33 33 33 46 33 33 33 33 33 33 33 33 33 33 33 33 33 33 33 20 33 34 33 35 
36 36 36 36 36 36 36 36 36 36 36 36 36 36 36 37 33 32 33 33 33 83 33 33 33 306 325 77 78 78 78 78 78 78 78 78 19 33 33 33 33 33 33 46 33 40 33 34 33 35 
36 36 36 36 36 36 36 70 56 56 56 56 56 56 56 57 33 32 33 33 33 33 33 33 33 305 306 39 5 5 347 306 104 105 106 327 322 33 33 33 85 33 33 33 33 33 20 34 33 35 
56 56 56 56 56 56 56 57 33 33 33 33 33 33 33 33 33 32 33 33 33 33 33 33 33 325 306 39 26 26 305 305 128 129 130 305 322 306 306 33 33 33 33 33 33 33 40 34 33 35 
7 8 8 9 33 20 20 33 33 33 80 33 33 33 33 33 60 32 33 33 33 67 33 33 33 33 306 97 98 79 305 303 180 187 182 305 322 306 325 306 306 33 64 33 33 33 68 34 33 35 
47 48 48 49 20 21 40 33 33 33 33 33 33 12 13 13 13 329 33 33 33 33 33 33 24 33 33 33 33 38 307 305 305 305 305 305 322 306 306 306 33 33 33 33 33 33 43 34 33 35 
33 20 20 20 21 40 33 33 33 33 33 33 33 32 82 33 33 33 33 20 20 20 20 20 20 20 20 6 33 58 98 98 341 305 341 341 342 306 306 33 33 33 33 308 53 53 53 54 33 35 
33 40 40 40 40 61 33 33 33 33 33 33 33 32 33 45 33 33 20 21 21 21 21 21 21 21 21 20 20 20 33 33 306 305 306 304 306 306 306 33 33 33 33 34 33 33 33 33 46 35 
33 33 33 33 33 33 33 33 33 33 33 33 33 32 33 65 33 20 21 21 21 21 21 21 21 21 21 21 21 21 20 33 33 33 33 33 33 33 33 33 33 33 33 34 33 15 16 16 16 91 
16 16 16 17 33 33 33 33 33 68 33 33 33 52 53 53 20 21 21 21 21 40 40 40 40 40 40 40 21 21 21 20 33 46 33 33 33 33 33 33 33 33 33 34 33 35 36 36 36 36 
36 36 36 90 16 17 33 33 33 33 33 33 33 33 33 33 21 21 21 21 40 5 5 5 5 5 5 5 40 21 21 21 20 53 53 53 53 51 33 50 53 53 53 54 33 35 36 36 36 36 
36 36 36 36 36 90 16 17 33 33 33 46 33 33 5 5 40 40 40 40 6 6 6 6 6 6 6 6 6 40 40 40 40 6 5 5 5 33 33 33 33 33 33 33 33 35 36 36 36 36 
36 36 36 36 36 36 36 37 44 4 33 33 33 6 5 6 5 6 6 6 6 33 33 33 33 6 6 6 6 6 6 6 6 6 6 6 33 33 33 33 69 33 33 33 15 91 36 36 36 36 
36 36 36 36 36 36 36 37 7 8 8 8 8 8 8 8 8 8 8 8 8 8 9 87 88 89 7 8 8 8 8 8 8 8 8 8 8 8 8 8 8 8 8 9 35 36 36 36 36 36 
36 36 36 36 36 36 36 37 27 28 28 28 28 28 28 28 28 28 28 28 28 28 29 107 108 109 27 28 28 28 28 28 28 28 28 28 28 28 28 28 28 28 28 29 35 36 36 36 36 36 
36 36 36 36 36 36 36 37 47 48 48 48 48 48 48 48 48 48 48 48 48 48 49 33 33 33 47 48 48 48 48 48 48 48 48 48 48 48 48 48 48 30 28 29 35 36 36 36 36 36 
36 36 36 36 36 36 36 37 24 33 33 20 20 20 20 20 20 20 20 33 33 33 33 33 33 33 33 33 20 20 20 20 20 20 20 20 20 20 20 20 33 27 28 29 35 36 36 36 36 36 
36 36 36 36 36 36 36 37 33 33 33 40 40 21 21 21 21 21 21 20 20 20 20 33 33 46 20 20 21 21 21 21 21 21 21 21 21 40 40 40 33 27 28 29 35 36 36 36 36 36 
36 36 36 36 36 36 36 37 33 33 7 8 9 21 21 21 21 21 21 21 21 21 21 20 20 20 21 21 21 21 21 21 21 21 21 40 40 69 33 33 33 27 28 29 35 36 36 36 36 36 
36 36 36 36 36 70 56 57 33 33 27 28 29 40 21 21 21 21 21 21 21 21 21 21 21 21 21 21 21 21 21 40 40 40 40 33 24 33 46 33 33 27 28 29 35 36 36 36 36 36 
36 36 36 70 56 57 33 33 33 33 27 28 11 9 40 21 21 21 21 21 21 21 21 21 21 21 21 21 21 21 40 33 33 33 33 33 33 33 33 33 33 27 28 29 35 36 36 36 36 36 
56 56 56 57 33 33 33 33 33 33 27 28 28 29 33 40 40 40 40 40 40 40 40 40 40 40 40 40 40 40 33 33 33 74 75 76 33 33 33 33 33 27 28 29 35 36 36 36 36 36 
33 33 64 33 33 33 33 33 33 84 47 48 48 49 33 33 33 33 33 33 64 33 15 16 16 16 16 16 17 33 33 46 33 114 93 116 33 33 85 33 33 27 28 29 35 36 36 36 36 36 
33 33 33 33 33 33 33 33 33 33 33 33 33 33 33 33 33 33 33 33 33 33 35 36 36 36 36 36 37 33 33 33 33 33 33 4 33 33 33 33 33 27 28 29 35 36 36 36 36 36 
16 16 16 16 16 16 16 16 16 16 16 16 16 16 16 16 16 16 16 17 33 61 35 36 36 36 36 36 90 16 16 16 17 7 8 8 8 8 8 8 8 10 28 29 35 36 36 36 36 36 
36 36 36 36 36 36 36 36 36 36 36 36 36 36 36 36 36 36 36 90 16 16 91 36 36 36 36 36 36 36 36 36 37 27 28 28 28 28 28 28 28 28 28 29 35 36 36 36 36 36 
36 36 36 36 36 36 36 36 36 36 36 36 36 36 36 36 36 36 36 36 36 36 36 36 36 36 36 36 36 36 36 36 37 47 48 48 48 48 48 48 48 48 48 49 35 36 36 36 36 36 
36 36 36 36 36 36 36 36 36 36 36 36 36 36 36 36 36 36 36 36 36 36 36 36 36 36 36 36 36 36 36 36 90 16 16 16 16 16 16 16 16 16 16 16 91 36 36 36 36 36 
36 36 36 36 36 36 36 36 36 36 36 36 36 36 36 36 36 36 36 36 36 36 36 36 36 36 36 36 36 36 36 36 36 36 36 36 36 36 36 36 36 36 36 36 36 36 36 36 36 36 
36 36 36 36 36 36 36 36 36 36 36 36 36 36 36 36 36 36 36 36 36 36 36 36 36 36 36 36 36 36 36 36 36 36 36 36 36 36 36 36 36 36 36 36 36 36 36 36 36 36 
36 36 36 36 36 36 36 36 36 36 36 36 36 36 36 36 36 36 36 36 36 36 36 36 36 36 36 36 36 36 36 36 36 36 36 36 36 36 36 36 36 36 36 36 36 36 36 36 36 36 
36 36 36 36 36 36 36 36 36 36 36 36 36 36 36 36 36 36 36 36 36 36 36 36 36 36 36 36 36 36 36 36 36 36 36 36 36 36 36 36 36 36 36 36 36 36 36 36 36 36 
36 36 36 36 36 36 36 36 36 36 36 36 36 36 36 36 36 36 36 36 36 36 36 36 36 36 36 36 36 36 36 36 36 36 36 36 36 36 36 36 36 36 36 36 36 36 36 36 36 36 
36 36 36 36 36 36 36 36 36 36 36 36 36 36 36 36 36 36 36 36 36 36 36 36 36 36 36 36 36 36 36 36 36 36 36 36 36 36 36 36 36 36 36 36 36 36 36 36 36 36 
36 36 36 36 36 36 36 36 36 36 36 36 36 36 36 36 36 36 36 36 36 36 36 36 36 36 36 36 36 36 36 36 36 36 36 36 36 36 36 36 36 36 36 36 36 36 36 36 36 36 
36 36 36 36 36 36 36 36 36 36 36 36 36 36 36 36 36 36 36 36 36 36 36 36 36 36 36 36 36 36 36 36 36 36 36 36 36 36 36 36 36 36 36 36 36 36 36 36 36 36 
36 36 36 36 36 36 36 36 36 36 36 36 36 36 36 36 36 36 36 36 36 36 36 36 36 36 36 36 36 36 36 36 36 36 36 36 36 36 36 36 36 36 36 36 36 36 36 36 36 36 
