18 18 18 18 18 18 18 18 18 18 18 18 18 18 18 18 18 18 18 18 18 18 18 18 18 18 18 18 18 18 18 18 18 18 18 18 18 18 18 18 18 18 18 18 18 18 18 18 18 18 
18 18 18 18 18 18 18 18 18 18 18 18 18 18 18 18 18 18 18 18 18 18 18 18 18 18 18 18 18 18 18 18 18 18 18 18 18 18 18 18 18 18 18 18 18 18 18 18 18 18 
18 18 18 18 18 18 18 18 18 18 18 18 18 18 18 18 18 18 18 18 18 18 18 28 26 26 26 26 26 26 26 26 29 18 18 18 18 18 18 18 18 18 18 18 18 18 18 18 18 18 
18 18 18 18 18 18 18 18 18 18 18 18 18 18 18 18 18 18 18 18 18 18 28 27 1 1 1 1 1 1 1 16 25 29 18 18 18 18 18 18 18 18 18 18 18 18 18 18 18 18 
18 18 18 18 18 18 18 18 18 18 18 18 18 18 18 18 18 18 18 18 18 28 27 1 1 1 2 1 1 1 1 1 1 23 18 18 18 18 18 18 18 18 18 18 18 18 18 18 18 18 
18 18 18 18 18 18 18 18 18 18 18 18 18 18 18 18 18 18 18 18 18 24 1 16 1 1 1 1 2 1 1 1 1 23 18 18 18 18 18 18 18 18 18 18 18 18 18 18 18 18 
18 18 18 18 18 18 18 18 18 18 18 18 18 18 18 18 18 28 26 26 26 27 1 1 1 2 1 1 1 1 1 16 1 25 26 29 18 18 18 18 18 18 18 18 18 18 18 18 18 18 
18 18 18 18 18 18 18 18 18 18 18 18 18 18 18 18 18 24 12 10 10 10 10 10 10 10 10 10 10 10 10 10 10 10 13 23 18 18 18 18 18 18 18 18 18 18 18 18 18 18 
18 18 18 18 18 18 18 18 18 18 18 18 18 18 28 26 26 27 8 3 3 3 3 3 3 3 3 3 3 3 3 3 3 3 7 25 29 18 18 18 18 28 26 26 26 26 26 26 29 18 
18 18 18 18 18 18 28 26 26 26 26 26 26 26 27 16 16 16 8 3 4 5 5 5 5 5 5 5 5 5 5 5 6 3 7 16 25 26 26 26 26 27 12 10 10 10 10 13 23 18 
18 18 18 18 18 18 24 12 10 10 10 10 10 10 10 10 10 10 11 3 7 20 21 21 21 21 21 21 22 16 2 16 8 3 9 10 10 10 10 10 10 10 11 3 3 3 3 7 23 18 
18 18 18 18 18 18 24 8 3 3 3 3 3 3 3 3 3 3 3 3 7 25 26 29 18 18 18 18 30 22 1 16 8 3 3 3 3 3 3 3 3 3 3 3 3 4 5 15 23 18 
18 18 18 18 18 18 24 8 3 4 5 5 5 5 5 5 5 5 5 5 15 2 1 25 26 26 26 29 18 30 21 22 14 5 5 5 5 5 5 5 5 5 5 6 3 7 20 21 31 18 
18 18 18 18 18 18 24 8 3 7 1 2 16 20 21 21 21 21 21 21 21 22 1 1 1 1 1 23 18 18 18 30 21 21 21 21 21 21 22 16 1 2 1 8 3 7 23 18 18 18 
18 18 18 18 18 18 24 8 3 7 20 21 21 31 18 18 18 18 18 18 18 30 21 21 22 1 20 31 18 18 18 18 18 18 18 18 18 18 30 22 16 1 16 8 3 7 25 29 18 18 
18 18 18 18 18 18 24 8 3 7 23 18 18 18 18 18 18 18 18 18 18 18 28 26 27 1 25 26 26 26 29 18 18 18 18 18 18 18 18 30 22 16 1 8 3 7 16 23 18 18 
18 18 18 18 18 18 24 8 3 7 23 18 18 18 18 18 28 26 26 26 26 26 27 1 1 1 1 1 1 1 25 29 18 18 18 18 18 18 18 18 30 22 16 8 3 7 16 23 18 18 
18 18 18 18 18 18 24 8 3 7 23 18 18 18 18 18 24 16 16 16 16 12 10 10 10 13 1 41 42 43 1 25 29 18 18 18 18 18 18 18 18 24 2 8 3 7 16 23 18 18 
18 18 18 18 18 18 24 8 3 7 23 18 18 18 18 18 24 16 2 2 1 8 3 3 3 7 1 38 39 40 1 1 23 18 18 28 26 26 26 26 29 30 22 8 3 7 16 23 18 18 
18 18 18 18 18 18 24 8 3 7 23 18 18 18 18 18 30 21 21 22 16 14 5 6 3 7 1 12 10 13 2 1 25 26 26 27 1 1 1 1 25 26 27 8 3 7 16 23 18 18 
18 18 18 18 18 28 27 8 3 7 25 26 26 26 26 26 26 26 26 27 1 1 1 8 3 9 33 11 3 7 1 1 1 1 1 1 2 1 1 1 1 2 1 8 3 7 16 23 18 18 
18 18 18 18 18 24 2 8 3 9 10 10 10 10 10 10 10 10 10 10 10 10 10 11 3 3 3 3 3 7 16 1 20 22 1 1 1 20 21 22 1 1 1 8 3 7 20 31 18 18 
18 18 18 18 18 24 16 8 3 3 3 3 3 3 3 3 3 3 3 3 3 3 3 3 3 4 5 5 5 15 1 1 23 30 21 21 21 31 18 30 21 21 22 8 3 7 23 18 18 18 
18 18 18 18 18 30 22 14 5 6 3 4 5 5 5 5 5 5 5 5 5 5 5 5 5 15 1 1 1 2 1 1 23 18 18 18 18 18 18 18 28 26 27 8 3 7 23 18 18 18 
18 18 18 18 18 18 24 1 16 8 3 7 1 2 1 16 1 20 21 22 16 16 16 1 20 21 21 22 1 20 21 21 31 18 18 18 18 18 18 18 24 16 2 8 3 7 23 18 18 18 
18 18 18 18 18 18 24 1 2 8 3 7 16 1 16 16 20 31 18 30 21 21 21 21 31 18 18 30 21 31 18 18 18 18 18 18 18 18 18 28 27 1 1 8 3 7 23 18 18 18 
18 18 18 18 18 18 30 22 1 8 3 7 20 21 21 21 31 18 18 18 18 28 26 26 26 26 26 26 29 18 18 18 18 18 18 18 18 18 28 27 1 1 16 8 3 7 23 18 18 18 
18 18 18 18 18 18 18 24 1 8 3 7 25 26 26 26 29 18 18 18 28 27 2 16 12 10 13 16 25 29 18 18 18 18 18 18 28 26 27 1 16 2 16 8 3 7 23 18 18 18 
18 18 18 18 18 18 18 30 22 8 3 9 10 10 10 13 23 18 18 18 24 1 1 16 8 36 7 16 1 23 18 18 18 18 18 28 27 1 12 10 10 10 10 11 3 7 23 18 18 18 
18 18 18 18 18 18 18 18 24 8 3 3 3 3 3 7 23 18 18 18 24 1 1 16 8 3 7 16 1 23 18 18 18 18 28 27 1 2 8 3 3 3 3 3 3 7 23 18 18 18 
18 18 18 18 18 18 18 18 24 14 5 5 5 6 3 7 25 29 18 18 30 22 1 16 8 3 7 16 20 31 18 18 18 18 24 1 16 1 8 3 4 5 5 5 5 15 23 18 18 18 
18 18 18 18 18 18 18 18 30 21 22 16 2 8 3 7 1 25 29 18 18 30 21 22 8 3 7 21 31 18 18 18 28 26 27 16 16 16 8 3 7 20 21 21 21 21 31 18 18 18 
18 18 18 18 18 18 18 18 18 18 30 22 16 8 3 7 16 1 25 26 26 26 26 27 8 3 7 26 26 26 26 26 27 16 16 1 2 16 8 3 7 23 18 18 18 18 18 18 18 18 
18 18 18 18 18 18 18 18 18 18 18 24 16 8 3 9 10 10 10 10 10 10 10 10 11 3 9 10 10 10 10 10 10 10 10 10 10 10 11 3 7 23 18 18 18 18 18 18 18 18 
18 18 18 18 18 18 18 18 18 18 18 30 22 8 3 3 3 3 3 3 3 3 3 3 3 3 3 3 3 3 3 3 3 3 3 3 3 3 3 3 7 23 18 18 18 18 18 18 18 18 
18 18 18 18 18 18 18 18 18 18 18 18 24 14 5 5 5 5 5 5 5 5 5 5 5 5 5 5 5 5 5 5 5 5 5 5 5 5 5 5 15 23 18 18 18 18 18 18 18 18 
18 18 18 18 18 18 18 18 18 18 18 18 30 21 21 21 21 21 21 21 21 21 22 1 16 2 1 2 16 1 20 21 21 21 21 21 21 21 21 21 21 31 18 18 18 18 18 18 18 18 
18 18 18 18 18 18 18 18 18 18 18 18 18 18 18 18 18 18 18 18 18 18 30 21 21 21 21 21 21 21 31 18 18 18 18 18 18 18 18 18 18 18 18 18 18 18 18 18 18 18 
18 18 18 18 18 18 18 18 18 18 18 18 18 18 18 18 18 18 18 18 18 18 18 18 18 18 18 18 18 18 18 18 18 18 18 18 18 18 18 18 18 18 18 18 18 18 18 18 18 18 
32 18 18 18 18 18 18 18 18 18 18 18 18 18 18 18 18 18 18 18 18 18 18 18 18 18 18 18 18 18 18 18 18 18 18 18 18 18 18 18 18 18 18 18 18 18 18 18 18 18 
32 18 18 18 18 18 18 18 18 18 18 18 18 18 18 18 18 18 18 18 18 18 18 18 18 18 18 18 18 18 18 18 18 18 18 18 18 18 18 18 18 18 18 18 18 18 18 18 18 18 
32 3 3 3 3 3 3 3 3 3 3 3 3 3 3 3 18 18 18 18 18 18 18 18 18 18 18 18 18 18 18 18 18 18 18 18 18 18 18 18 18 18 18 18 18 18 18 18 18 18 
32 3 3 3 3 3 3 3 3 3 3 3 3 3 3 3 18 18 18 18 18 18 18 18 18 18 18 18 18 18 18 18 18 18 18 18 18 18 18 18 18 18 18 18 18 18 18 18 18 18 
32 3 32 32 32 32 32 3 32 32 32 32 32 32 3 3 18 18 18 18 18 18 18 18 18 18 18 18 18 18 18 18 18 18 18 18 18 18 18 18 18 18 18 18 18 18 18 18 18 18 
32 3 32 17 17 17 17 17 17 17 17 17 17 32 3 3 18 18 18 18 18 18 18 18 18 18 18 18 18 18 18 18 18 18 18 18 18 18 18 18 18 18 18 18 18 18 18 18 18 18 
32 3 32 17 17 17 17 17 17 17 17 17 17 32 3 3 18 18 18 18 18 18 18 18 18 18 18 18 18 18 18 18 18 18 18 18 18 18 18 18 18 18 18 18 18 18 18 18 18 18 
32 3 32 17 17 17 17 17 17 17 17 17 17 32 3 3 18 18 18 18 18 18 18 18 18 18 18 18 18 18 18 18 18 18 18 18 18 18 18 18 18 18 18 18 18 18 18 18 18 18 
32 3 32 17 17 17 17 17 17 17 17 17 17 32 3 3 18 18 18 18 18 18 18 18 18 18 18 18 18 18 18 18 18 18 18 18 18 18 18 18 18 18 18 18 18 18 18 18 18 18 
32 3 32 32 32 32 32 32 32 32 32 32 32 32 3 3 18 18 18 18 18 18 18 18 18 18 18 18 18 18 18 18 18 18 18 18 18 18 18 18 18 18 18 18 18 18 18 18 18 18 
32 32 32 32 32 32 32 32 32 32 32 32 32 32 32 32 32 32 32 32 18 18 18 18 18 18 18 18 18 18 18 18 18 18 18 18 18 18 18 18 18 18 18 18 18 18 18 18 18 18 
